###############
#   v v v     #
#      f      #
# #    #    #@#
#a#        h# #
#g#h        ###
#a#        h#a#
#g#h   #    #g#
# #        h#a#
###h   #    # #
#0            #
#b            #
#####=#########
#tgga        g#
###############
