###############
#      @     0#
#v            #
#v            #
#v            #
# #############
# #ggg h ggg#v#
#     b       #
#######=##### #
#        raaa #
#f ############
#  hhhhhh    n#
#####f    #####
#gggrggggggggr#
###############
