###############
#            @#
#   ###########
#        h    #
#0      a#    #
##########=## #
# #ggg h ggg#v#
#       #===# #
#v      ##### #
##a      aaaa #
#h ####f#######
#            h#
#        b#####
#ggrgggggghagt#
###############
